10
10
WWWWWWWWW
WMEEEEEEW
WEEEEEEEW
WEEEEEEEW
WEEEEEEEW
WEEEEEEEW
WEEEEEEEW
WEEEEEEEW
WEEEEEEXW
WWWWWWWWW