WWWWWWWWW
WMEEWEEEW
WEEEWEEEW
WEEEWEEEW
WEEEEEEEW
WEEEEEEEW
WEEEEEEEW
WEEEEEEEW
WEEEEEEXW
WWWWWWWWW