EEEWWEEE
EEWWWWEE
EEEEEEEE
EEEWWEEE
EEWEWWWE
EEWEEWEE
EEEEEEEE
EEEEEEEX