MEEEEWEEEE
EEEEEWEEEE
EEEEEEEEEE
EWEEEEWWWW
EEEEEEEEEE
EEWEEEEEEE
EEWWWEEEEE
EEEWWWEEEE
EEEEEWEEEE
EEEEEEEEEX