EEEWWEEE
EEWWWWEE
EEEEEEEE
EEEWWEEE
EEWEWWWE
EEWWWWEE
EEEEWWWW
EEEEEEEX