EEEEEEEEEE
EEWWWEEWWW
EEEWWEEEWW
EWEWEWEWEW
WEEEEEEEEE
WEEEEEEEEE
WWWEEEEEEE
EEEEEEEEEE
EEEEEEEEEE
EEEEEEEEEX