EEEEEEEEEE
EEWWWEEWWW
EEEWWEEEWW
EWEWEWEWEW
WEEEEEEEEE
WEEEEEEEEE
WWWEEEEEEE
WWWEEWWWWE
WWWEWWWEEE
EEEEEEEEEX