EEEEEWWWE
EEWWEWEWE
EEEEEEEEE
WWEWWEWWE
EEEEEEEEE
EWEEWWEEE
WWWEWWWEE
WWEEEEEEE
WWWEEEEEX