MEEEEEEEEEEEE
EEEEEEEEEEEEE
EEEEEEEEEEEEE
EEEEWWEEEEEEE
EEEEEEEEWWWEE
EEEEEEEEEEEEE
EEEEEWWWWEEEE
EEEEEEEEEEEEE
WWWWWWWEEEEEE
WWWWWWWWWWEEE
WWWWWWEEEEEEE
EEEEEEEEEEEEE
WWWWEEEEEEEEX