MEEEEEEEEEEEWEE
EEEEEEEEWWWWWWW
WEWEEEEEWEEEEEE
EEWEEEEEWEEWWW
WWWEEEEEEEEEWEE
EEWEEEEEEEEEWEE
EWWWEEEEEEEWWWE
EEWEEEEEEEEEWEE
EEWWWEWWWEWWWEE
EEEWEEEEEEEEEEX
WWWWEWWEEEEEWEE
WEEEEEWEEEEEWWW
WEEWEEWEEEEEEEW
WWWWWWWWWEEEWWW
EEEEEEEEEEEEEEE