EEEEEEEWWWWWWW
EEEEEEEEWWWWWW
EEWEEEEEEWWWWW
EEEWEEEEEEWWWW
EEEEWEEEEEEWWW
EEEEEWEEEEEEWW
WEEEEEWEEEEEEW
WWEEEEEWEEEEEE
WWWEEEEEWEEEEE
WWWWEEEEEWEEEE
WWWWWEEEEEWEEE
WWWWWWEEEEEWEE
WWWWWWWEEEEEEE
WWWWWWWWEEEEEX