EEEEEEEEEEEE
EEEEEEEEEEEE
EEEEEEEWWWWE
EEEEEEEEEEEE
EEEWWEEEEEEE
EEEWWWEEEEEE
EEEEEEEEEEEE
EEEEEEEEEEEE
EEEEEEEEEWWW
EEEEEEEEEEWW
EEEEXEEEEEEE
EEEEEEEEEEEE