EEEEWEEEEEEWEEEE
EEWEWEEEEEEEEEEE
EEWEWEEEEEEWWWWE
EEWWWEEEEEEEEWWE
EEWEEEEEEEEWEWWE
EEWEEEEWEEEEWWWE
EEWEEEEEEEEEEEEE
EEWEWWWEEEEEWWWE
EEEEEEEEEEEEEEWE
EWWWWWWWEEEEEEWE
WWWWWWWEEEEEEEEE
EEEEEEEWEEEEWWWE
EEEEEEEEEEEEEEEE
EEWWWWEEEEEEEEEE
EEEEEXWWWEEEEEEE
EEEEEEEWWWWEEEEE