MEWEEEEEEEE
EEWEEEEEEEE
EEWWWWWWEEE
EEEEEEEWEEE
EEEEWEEWEEE
EEEEWEEWEEE
EEEEWWWWEEE
EEEEWEEEEEE
EEEEWEEEEEE
EEEEEEEEEEE
EEEEEEEEEEX